## 견종
- 견종 무관(일반): 소형견/중대형견만 이용이 가능하다는 언급이 없다면 TRUE로 표기
- 소형견 전용: 소형견만 이용이 가능 여부
- 중대형견 전용: 중대형견만 이용이 가능 여부
- 고양이: 고양이 이용 가능 여부

## 서비스(보호자)
- 발렛파킹: 발렛 파킹 여부
- 유료 픽드랍: 픽드랍 서비스 유료 제공 여부 (관련 키워드: '픽업 가능')
- 무료 픽드랍: 픽드랍 서비스 무료 제공 여부 (관련 키워드: '픽업 가능')
- 1:1 알림장: 알림장 제공 여부 (예: ‘매일매일 어떤 놀이를 했는지, 어떤 친구들과 놀았는지 꼼꼼한 기록을 보내드려요’와 같은 맥락일 경우 TRUE)
- 기타: 이외 제공 되는 기타 서비스가 있다면 한글 텍스트로 기재 (예: ‘유기견 할인’, ‘영상 피드백 제공’, ‘퇴소 교육’, ‘지속 피드백’)

## 서비스(강아지)
- 24시간 상주: 관리자, 직원 등 강아지 돌봄 인력이 24시간 상주가 가능한 경우
- 성향분석: 강아지 성향과 성격을 면밀히 분석하는 서비스가 있는 경우
- 분반: 강아지 크기, 견종, 성격, 질병, 나이 등 안전하게 특정 기준에 따라 분리되는 반이 있는 경우
- 호텔링: 강아지 호텔링 서비스 제공 여부
- 데이케어: 주간 돌봄 서비스 제공 여부
- 목욕: 목욕 서비스 제공 여부
- 수중 피트니스: 수영장을 이용한 수중 운동 프로그램 제공 여부
- 마사지: 강아지 마사지 서비스 제공 여부
- 미용: 강아지 이발 서비스 제공 여부
- 훈련: 강아지 훈련 프로그램 제공 여부
- 행동교정: 강아지의 잘못된 습관 혹은 반복되는 문제 행동을 교정해주는 프로그램 제공 여부
- 산책: 강아지 산책 서비스 제공 여부
- 재활: 강아지 부상, 디스크 등 질환 개선 목적의 재활 프로그램 제공 여부
- 병원 연계: 동물병원과 연계되는 병원 시설 혹은 서비스 제공 여부
- 기타: 위 항목 외 제공 되는 기타 서비스가 있다면 한글 텍스트로 기재

## 시설(방문객)
- 주차장: 방문객을 위한 주차 공간 제공 여부
- 강아지 카페: 업체 시설 내 강아지 카페 구비 및 운영 여부
- 강아지 용품: 업체 시설 내 강아지 용품 판매 여부
- 기타: 위 항목 외 제공 되는 기타 서비스가 있다면 한글 텍스트로 기재

## 시설(강아지)
- 미끄럼방지: 시설 내 강아지 활동 공간 내 바닥에 미끄럼 방지 처리가 되어 있는 경우
- CCTV: 업체 시설 내 CCTV 설치 여부
- 실내 놀이터: 실내 놀이터 여부 (놀이 공간이 아닌 놀이터)
- 실외 놀이터: 실외 놀이터 여부 (놀이 공간이 아닌 놀이터)
- 루프탑: 옥상, 루프탑 공간 제공 여부
- 테라스: 업체 시설 내 테라스 공간 제공 여부
- 운동장: 업체 시설 내 강아지를 위한 실내 혹은 실외 운동장 공간 제공 여부 (테라스나 루프탑에 있을 경우, 같이 True 처리)
- 마당: 마당 공간 제공 여부
- 수영장: 수영장 시설 제공 여부
- 개별 룸: 개별 룸 제공 여부
- 기타: 위 항목 외 제공 되는 기타 서비스가 있다면 한글 텍스트로 기재

## 전문가 자격증
- 훈련사: 직원 중 '전문 훈련사' 자격증 보유 여부
- 반려동물관리사: '반려동물관리사' 자격증 보유 여부
- 수의사: '수의사' 자격증 보유 여부
- 기타: 위 항목 외 제공 되는 기타 서비스가 있다면 한글 텍스트로 기재

## 가격 정책
- 횟수권: 횟수별 이용권 제공 여부 (단일권, 1회 이용권도 횟수권으로 포함할 것)
- 정기권: 정기 이용권 제공 여부
- 멤버십: 멤버십 제도 운영 여부